1111111111111111111111111111111111
1E1000000000000C00001C100000000001
1000010100100000101000100000010101
1010010010101010001001000000010101
10P000000C00C0000000000000000000C1
1111111111111111111111111111111111
