111111111111111111111111111111111111111111111111111111111111111
100000C000000C000000C0000000000C000000000000000000C000000000001
101C1010101C10101C10101C1010101C10101C10101010101C1010101010101
10000000C000000000C0000000C0000000000000C000000000C000000C00001
101C10101C10101C101C1010101C1010101C101010101C101C1010101C10101
1000C000000000C000000C00000C0000C000000C00000000000C000000C0001
10101C10101C101C10101C101C10101010101C101010101C1010101C1010101
100000C000000000C0000000000000C00000C00000000000C00000C00000001
1010101C10101C101010101C1010101C101010101C1010101C1C10101010101
1000000000C000000000000C0000000000C0000000000C000000C0000000001
101010101C101010101C10101C101010101C101010101C10101010101010101
100000000000C00000C000000000C00000E0000000000000C000000000000P1
111111111111111111111111111111111111111111111111111111111111111
