111111111111111111111111111111111111111111111111111111111111111111111111111111111111111111
1E000000000000000000000000000000000000000000000000000000000000000000000000000000000C000001
1000000000000000000C0000000000000000000000000000000000000000000000000000000000000000000001
100000000000000000000000000000000000000000000000000000000000000001000000000000000000000001
10000000000000000000000000000000000000000C000000000100000000000000000000000000000000000001
100000000000000000000000000000000000000000000000000000000000000000000000000000000000000001
100000000000000000000000000000000000000000000000000100000000000000000000000000000000000P01
111111111111111111111111111111111111111111111111111111111111111111111111111111111111111111
